B N N N N N B B B N N N N N B
N B N N N B N N N B N N N B N
N N B N B N B N B N B N B N N
G N N B N N N N N N N B N N N
N N N N B B B B B B B N N N B
B N N N B N N N N N B N N B N
N B N N N B N N N B N N B N N
B N N N N B B B B B N N N B N
N N N N B N N N N N B N N N B
N N N B N N N N N N N B N N N
N N N B N N N N N N N B N S N
N N N N N N N N N N N N N N N
N N N N N N N N N N N N N N N
N B N B N B N B N B N B N B N
B N B N B N B N B N B N B N B