S N N N N N N N N N N N N N N
B B B B N B N N B N B B B B N
B N N B N B N N B N B B B B N
B B B B N N B B N N N B B N N
B N N N N N B B N N N B B N N
B N N N N N B B N N N B B N N
N N N N N N N N N N N N N N N
N N N N N N N N N N N N N N N
B N N B N B B B B N B N N B N
B N N B N B N N B N B B N B N
B B B B N B N N B N B B B B N
B N N B N B N N B N B N B B N
B N N B N B B B B N B N N B N
N N N N N N N N N N N N N N N
N N N N N N N N N N N N N N G